##......#.
#.....#...
..##.....#
#........#
#......#.#
..#.......
###.......
..........
..........
#...##....
