..........
.##.#..#.#
.#........
...##.....
........#.
..........
#...##....
#......#..
..##...##.
..##......
