.......##.
.....#....
...#.#....
.#...#....
.#........
..........
...##....#
...##.....
......#...
##.#.##.#.
